title	labels
自然に目が大きく見える着色直径で、大人の女性も使いやすいデザイン。	商品/サービス特徴
店長、店長候補、店長補佐の求人	
カンタン無料登録で、気になる作品がいつでも・どこでも・今スグ読める！	利便性|無料
作品数Ｎｏ．１の動画・映像配信サービスｄＴＶ。１９９５年の「バッドボーイズ」、２００３年の「バッドボーイズ２バッド」から１７年ぶりとなった「バッドボーイズ」シリーズの第３弾。製作に、「アルマゲドン」、「パイレーツ・オブ・カリビアン」シリーズのジェリー・ブラッカイマーが名を連ねる。	最大級・No.1|商品/サービス特徴
公式サイトだから安心	
100万件以上の求人掲載中。日本最大級のアルバイト求人サイト/バイトル	品揃え|最大級・No.1
天空のリゾート！奥三河の雄大な自然に包まれた、ピーター・トムソン小笹昭三設…	商品/サービス特徴
話題のコラーゲンサプリを美容マニアが徹底比較!1位に輝く商品をここからチェックしよう	最大級・No.1|商品/サービス特徴
カンタン売却依頼はコチラ	
リクルート運営の就活準備サイト／インターンシップ・1day仕事体験応募可能企業数6年連続No.1	最大級・No.1
まずはかんたんシミュレーション	利便性
携帯決済OK／auPAYマーケット	利便性
妊婦さん限定で無料配信中	限定|対象限定|無料
ディズニー グッズ 激安等のキャラクターアイテムを買うならau PAY マーケット。ディズニー グッズ 激安などキャラクター・アニメに関する商品が満載。3,000万アイテム以上の豊富な品揃え。セール、送料無料の商品も多数！	無料|品揃え|オファー|商品/サービス特徴
送料無料の商品多数ご用意/人気順や価格順、詳細検索等で欲しい物きっと見つかる!	品揃え|無料|商品/サービス特徴
世界52カ国以上に展開するグローバルタイヤブランドのMINERVA(ミネルバ)。低価格でありながら品質の良さに定評のあるタイヤを一挙ラインナップ!	品揃え|高品質
実力派・行定勲監督が話題のケータイ連載小説を大胆かつ斬新に映画化	商品/サービス特徴
あのスナック菓子のセット・詰め合わせ販売中！家庭用／ギフト用もお得な価格でご提供	オファー|商品/サービス特徴
雨の日でも大丈夫! 家から出なくてもドミノ･ピザを楽しめる、ポイントも貯まる	還元
【2021年死亡保険ランキング】	
自宅から参加できるオーキャンで学校情報を手に入れよう。簡単予約はこちらから	利便性|商品/サービス特徴
売却のプロが査定/SRE不動産	
【無料】カンタン32秒で申し込み！最大10社に一括査定依頼できる	利便性|スピード|無料|商品/サービス特徴
距離は長くないが、要所に池やバンカーが配され点で攻めるショットが要求される…	商品/サービス特徴
MISUMI-VONA（公式）【ミスミ】	
創作イタリアンLa Casa Blanca	
株式会社LIXILのメーカー公式通販ストアです。LIXIL、TOSTEM、INAX、サンウエーブ、TOEX、新日軽の住宅設備機器のメンテナンス部品やオプション品、アクセサリを販売しています。 会員登録1,000円以上送料無料、在庫品当日出荷。「メーカー公式通販ストア」ならではの安心をお届けします。	スピード|高品質|無料|商品/サービス特徴
ザ コンチネンタル横浜の最新ブライダルフェア情報をご紹介！試食付き・試着付きなど内容盛りだくさんのフェアは必見です！人気の式場はフェアの予約も埋まるのが早くなっております。気になる式場のブライダルフェア予約はお早めに。	商品/サービス特徴
テイクアウトならピザが1枚500円！（税抜）【グラッチェガーデンズ練馬土支田店限定】	価格|対象限定
陣痛バッグにピッタリなマルチバッグorはらぺこあおむし柄の母子手帳ケースが合計1万名に当たる	特典
AGAスキンクリニックの治療が世界的に認められました	
大分県の宅配・出前なら／出前館	
高知市／スーパー・CVS・生協	
【商品点数2,000万品以上！】注目のミルクのネットショッピングなら通販サイトau PAY マーケット。人気の激カワファッションをサイズ・カラー・ブランドを豊富に取扱い。最新トレンドファッションやコスメ・グルメなど、2,000万品以上の豊富な品ぞろえ。	品揃え|商品/サービス特徴
安全装備が充実した新車に乗ることが可能!メンテナンスフルパッケージが受けられる	高品質|商品/サービス特徴
| エネトピア展TOP | ガス機器 | 特別パック | リフォーム | IH / エコキュート | のりかえ相談 | 特別特典 | お申し込み | IH/エコキュート 今年のエネトピア展は、電化機器もエネトピア展特別価格で取り揃えてます!ぜひこの機会にお買い求めください。 ※掲載の表示価格は全て税込みです。	特典|オファー
ドミノ・ピザの出前なら／出前館	
【リクナビ2022】公式サイト	
ゼクシィ内祝い(旧:赤すぐ内祝い)では、出産内祝い(出産祝いのお返し)や結婚内祝いを、「のし(熨斗)・写真入りメッセージカード・名入れ・三越伊勢丹の包装紙」など、おしゃれで人気なサービスを無料で使って贈れます。さらに2,500円(税抜)以上なら送料無料!	無料|商品/サービス特徴
ラヴェール／送料無料	無料
転職に年齢は関係ない！転職者の約8割が利用するリクナビNEXT。希望の求人が見つかる	その他|実績
真庭は比較的標高の高い場所にゴルフ場が点在/フラットから丘陵コースまで種類も豊富	品揃え
初めてのお買物でクーポンが貰える。お家時間もマルイウェブチャネルで楽しくお買物!	特典
種類豊富な最旬アイテムが続々!	その他|品揃え
全国の介護老人保健施設4168件。費用・料金などの条件から施設を探して、無料で資料請求・見学予約が可能。ランキングや相場情報もあわせてチェック!日本最大級の老人ホーム検索サイト、LIFULL介護(ライフル介護)。※HOME’S介護は、2017年4月1日にLIFULL介護に名称変更しました。	最大級・No.1|品揃え|無料|商品/サービス特徴
SETRE Glovershouse NAGASAKI (セトレグラバーズハウス長崎)の最寄駅は出島駅。【1日1組】隠れ家ホテルで叶える貸切W！試食付フェア開催中。ハナユメからのお申し込みで挙式費用が最大46万円おトクになることも！ブライダルフェア情報、おトクな割引特典、フォトギャラリー、口コミ、見積もり例が充実！結婚式場探しはハナユメ！	アクセス|価格|オファー|商品/サービス特徴
三井住友トラストL&Fの不動産担保ローンは銀行とはひと味違う取扱基準で幅広く対応。	商品/サービス特徴
人気メンズポロシャツの通販なら	
高価買取No.1の車査定比較サイト！愛車の買取相場を知ろう。50万円以上の査定額UPも	その他|価格|最大級・No.1
カプセルタイプやコラーゲンゼリー、コラーゲンドリンクなど、あなたにあったタイプを見つけよう	
南禅寺の近く、匠の技光る1200坪の日本庭園と大正邸宅。一味違う上質体験を皆に贈ろう	その他|商品/サービス特徴
ドリームグロウマスク（BL）の紹介ページです。重力× 表情× エイジングの関係に挑むフェイス& ネックシートマスクです。深い眠りから目覚めたような、すっきりとした表情が似合うみずみずしい肌へ導きます。	商品/サービス特徴
売上が3倍になった店舗も!楽天市場のECコンサルタントと一緒に"売れるお店"を作りませんか	
合同WEBセミナーでは企業の事業内容、先輩社員の話も紹介。気になる企業をチェックしよう！	その他|商品/サービス特徴
瞳に馴染む自然なレンズデザインだから、アイメイク感覚で毎日使いたくなる	商品/サービス特徴
贅を極めた名旅館と、往復JRのセットプラン。箱根旅行プラン充実／予約はJTB	商品/サービス特徴
フリーローンを64社から徹底比較!フリーローンとは趣味、旅行、買い物など、どんな目的でも利用できるローンです。カードローンやキャッシングよりも上限金利が低いケースが多く、安心して借り入れ可能です。また、証書貸付方式の契約なので、借り入れ後は原則返済をするだけ。借りすぎが不安な方にもオススメです。	商品/サービス特徴
レジャー・アミューズメント・スポーツ施設の求人・転職情報／限定求人約85％	限定
ぷるんとした、美しい色素薄い系のナチュラルな瞳に。外国人瞳を叶える最強ワンデー	その他|商品/サービス特徴
<大阪旅行・ツアーご予約はこちら>大阪グルメの食べ歩きも思いっきり堪能!/JTB	商品/サービス特徴
薬剤師のお仕事探しは日本最大級の薬剤師転職情報サイト【リクナビ薬剤師】詳細を今すぐチェック	最大級・No.1
人気メンズボトムスが色・柄・サイズ豊富にご用意！送料無料／即日発送商品多数。	スピード|品揃え|無料|商品/サービス特徴
カーセンサーなら最大"30社"から同時売却査定依頼ができ、大切な愛車の最高額がわかる！	品揃え
あなたの商品を楽天のネットショップで販売しませんか？選べる4つの出店プラン・費用をチェック	その他|商品/サービス特徴
つみたてNISAの取扱銘柄数が豊富だから好きなファンドが選べる!キャンペーンも実施中	品揃え|商品/サービス特徴
マタニティのあなたにプレゼント	その他|対象限定
旧三菱東京UFJ銀行。借入可能かホームページで簡易診断	利便性
2月無料お試しの受付は1月21日からです。0・1・2歳、この機会に始めてみませんか?	期間限定|無料
仙台市(宮城県)の車クリーニング(車内清掃)のプロの業者さんを探すなら、ユアマイスター☆エリアや料金、口コミや作業写真で比較して、地域で人気の仙台市(宮城県)の車クリーニング(車内清掃)の業者さんを選べます！無料で見積もりも可能。独自のメッセージ機能を使って、業者さんと直接やり取りをしながら、納得して依頼できます！	利便性|無料|商品/サービス特徴
安心して老後を迎えるために	その他
売りたい、買いたい、貸したい、/様々なご要望にお応えします。	
なりたい瞳や人気のブランド、イメージモデルからピッタリのカラコンを見つけよう	トレンド
チケット先行予約受付中。ファンクラブ"a-i"会員なら800円おトクな割引価格。今すぐ入会	その他|価格
【カラコン 全品送料無料・当日発送商品も】充実した品揃えのカラコン専門通販サイト。	スピード|品揃え|無料|商品/サービス特徴
プラスモードワンデー／送料無料	無料
親子で楽しみながら、学びの土台作りを。今、ママ達の間で話題のBaby Kumon。	トレンド|商品/サービス特徴
この機会にコツコツ積立はじめませんか?預入れ時の為替手数料がずーっと0円!	無料
JTBなら宿と航空券、新幹線がセットでお得。福岡 旅行プラン充実/予約はJTB	オファー|商品/サービス特徴
<愛車を納得の価格で売るために>数社の見積もりを比較して、1番高い査定価格で売却依頼!	オファー
月間保険ランキングであなたの保険選びをサポート!保険を徹底比較するなら保険市場。	商品/サービス特徴
次回の無料体験学習の予約開始を、メールでお知らせします。今すぐ登録!	
JR東海ツアーズなら、東海道新幹線＋ホテルのセットプランが満載！	
会員登録受付開始	
購入専門/売却専門のプロがサポート!売買に関する疑問点、なんでもご相談下さい	商品/サービス特徴
すっぴんでいることが増えた今…。≪盛れる≫人気のカラコンで、いつでも隙なし女子へ！	その他
女性の薄毛でお悩みの方は、AGAスキンクリニック レディース院へ!薄毛治療・FAGA治療・女性育毛をお考えの方は、私たち専門医にご相談ください。電話・メール・LINEにて無料カウンセリング予約が可能。	利便性|悩み解決
ユーザーの口コミ・評判でランキング。今、1番選ばれているウォーターサーバーはコレ	トレンド
借入可能かホームページで簡易診断/金利年1.8%-年14.6%	利便性|価格
INTER-CHAUSSURESはグローバルな視点とコンセプチュアルな個性が光る、シューズコンセプトショップ「インター・ショシュール」。自分らしいスタイルを謳歌したい女性に向けて、ハイクオリティな感性を提案します。"送料無料（一部商品を除く）・ポイント還元"	還元|無料|商品/サービス特徴
さりげなく瞳の印象をアップしてくれる全5カラーラインナップ	その他
妊婦の暇つぶし探し中のあなたへ	対象限定
現在と6ヵ月後の査定相場もすぐわかる!まずは無料で、一括査定依頼&買取相場をチェック	無料|商品/サービス特徴
まずはゼクシィ独自の価値観診断	
近くの宅配弁当を選んで配達可能！出前館オリジナルクーポンでおトクに	利便性|オファー
16歳だから。悩み、傷つき、恋をした。自分の一番大切なものとは/公式	あらすじ
自動車保険を比較して賢く節約!サービスや満足度でも徹底比較。≪保険市場≫	商品/サービス特徴
片手で楽々ボトル交換できる	利便性
住宅ローン完全ガイド|イー・ローン	商品/サービス特徴
ペット・ペットグッズのネットショッピングなら通販サイトau PAY マーケット。ペット・ペットグッズの人気商品が勢ぞろい。昆虫用品、生体、犬用品・ドッグフードなどランキングやレビューで商品を比較できる。特集や一押しアイテムからおすすめの商品を紹介！送料無料やセールでおすすめ商品も多数掲載！ポイントやクーポンで更におトク♪あなたの欲しい物がきっと見つかる♪	オファー|無料|商品/サービス特徴
【ミスミ】の総合Webカタログ。FA・金型部品、工具・消耗品などの通販・検索サイト、MISUMI-VONA	
